NO ./xpm/redbrick.xpm
SO ./xpm/eagle.xpm
WE ./xpm/wood.xpm
EA ./xpm/mossy.xpm
F 220,100,0
C 225,255,255
111111111111111111111111111111111
100000000011000000000000111111111
101100000111000000000000111111111
100100000000000000000000111111111
111111111011000001110000000000001
100000000011000001110111111111111
111101111111110111000000100011111
111101111111110111010100100011111
110000001101010111000000100011111
100000000000000011000000100011111
1N0000000000000011010100100011111
110000011101010111110111100011111
111101111111010111011110100011111
111111111111111111111111111111111