R 1920 1080
NO ./texture/redbrick.xpm
SO ./texture/bluestone.xpm
WE ./texture/eagle.xpm
EA ./texture/tile4.xpm

F 100,100,100
C 250,250,250

        1111111111111111111111111
        1000000000000000000000001
        1011000000000000001000001
        1001000000100000000100001
111111111011010000000000001000001
100011000011001001000111111111111
11110111111111011110000010001
11110111111111011101010010001
11100000110101011100000010001
10001000000000001100000010001
10000100000000001101010000001
1111000111010101111101111010111
11110111 1110101 1011110100S1
11111111 1111111 111111111111
