R 1280 800

NO ./texture/redbrick.xpm
SO ./texture/tile2.xpm
WE ./texture/eagle.xpm
EA ./texture/tile4.xpm

F 0,0,0
C 255,255,255

          111111
1111111111010001
1000010000101001
1000000000000001
1000000001111111
1111111111
    11        
    101
 11111111        1  
  100000011111  101
 10000011      1001
1000000111    1011
111100N000111111111
    100000000001
111111111111111111
   101
    1 
