R 640 480
NO ./texture/NO.xpm
SO ./texture/SO.xpm
WE ./texture/WE.xpm
EA ./texture/EA.xpm

F 110,153,15
C 255,255,255

        1111111111111111111111111
    E   1000000000000000000000001
        1100000000000000000000001
        1000000000000000000000001
111111111000000000000000000000001
100000000000000000000000000001111
10000000000000000000000000001
10000000000000000000000000001
10000000000000000000000000001
10000000000000000000000000001
10000000000000000001010000001
11000001110101011111011110101
11110111 1110111 101111010001
11111111 1111111 111111111111
